"filename", "language", "Python", "XML", "comment", "blank", "total"
"e:\博士阶段\BaiduSyncdisk\code_repository\sponge_city\project\src\utils\algo\bioretention_ponds.py", "Python", 57, 0, 33, 18, 108
"e:\博士阶段\BaiduSyncdisk\code_repository\sponge_city\project\src\utils\algo\concave_herbaceous_field.py", "Python", 57, 0, 33, 14, 104
"e:\博士阶段\BaiduSyncdisk\code_repository\sponge_city\project\src\utils\algo\figure_function.py", "Python", 229, 0, 39, 70, 338
"e:\博士阶段\BaiduSyncdisk\code_repository\sponge_city\project\src\utils\algo\general_functions.py", "Python", 105, 0, 12, 30, 147
"e:\博士阶段\BaiduSyncdisk\code_repository\sponge_city\project\src\utils\algo\green_roof.py", "Python", 58, 0, 33, 17, 108
"e:\博士阶段\BaiduSyncdisk\code_repository\sponge_city\project\src\utils\algo\green_roof_single.py", "Python", 376, 0, 157, 70, 603
"e:\博士阶段\BaiduSyncdisk\code_repository\sponge_city\project\src\utils\algo\non_point_pollution.py", "Python", 402, 0, 100, 66, 568
"e:\博士阶段\BaiduSyncdisk\code_repository\sponge_city\project\src\utils\algo\permeable_pavement.py", "Python", 57, 0, 33, 16, 106
"e:\博士阶段\BaiduSyncdisk\code_repository\sponge_city\project\src\utils\algo\rain_generate.py", "Python", 17, 0, 4, 9, 30
"e:\博士阶段\BaiduSyncdisk\code_repository\sponge_city\project\src\utils\algo\sponge_block.py", "Python", 165, 0, 22, 28, 215
"e:\博士阶段\BaiduSyncdisk\code_repository\sponge_city\project\src\utils\main.py", "Python", 71, 0, 24, 14, 109
"e:\博士阶段\BaiduSyncdisk\code_repository\sponge_city\project\src\utils\ui\block.py", "Python", 502, 0, 7, 8, 517
"e:\博士阶段\BaiduSyncdisk\code_repository\sponge_city\project\src\utils\ui\block.ui", "XML", 0, 866, 0, 1, 867
"e:\博士阶段\BaiduSyncdisk\code_repository\sponge_city\project\src\utils\ui\green_roof.py", "Python", 436, 0, 7, 8, 451
"e:\博士阶段\BaiduSyncdisk\code_repository\sponge_city\project\src\utils\ui\green_roof.ui", "XML", 0, 656, 0, 1, 657
"e:\博士阶段\BaiduSyncdisk\code_repository\sponge_city\project\src\utils\ui\rain_generate.py", "Python", 97, 0, 7, 8, 112
"e:\博士阶段\BaiduSyncdisk\code_repository\sponge_city\project\src\utils\ui\rain_generate.ui", "XML", 0, 227, 0, 1, 228
"e:\博士阶段\BaiduSyncdisk\code_repository\sponge_city\project\src\utils\ui\sim_dates.py", "Python", 80, 0, 7, 8, 95
"e:\博士阶段\BaiduSyncdisk\code_repository\sponge_city\project\src\utils\ui\sim_dates.ui", "XML", 0, 229, 0, 1, 230
"e:\博士阶段\BaiduSyncdisk\code_repository\sponge_city\project\src\utils\ui\sponge_block.py", "Python", 167, 0, 7, 8, 182
"e:\博士阶段\BaiduSyncdisk\code_repository\sponge_city\project\src\utils\ui\sponge_block.ui", "XML", 0, 274, 0, 1, 275
"e:\博士阶段\BaiduSyncdisk\code_repository\sponge_city\project\src\utils\ui\sponge_city.py", "Python", 477, 0, 10, 9, 496
"e:\博士阶段\BaiduSyncdisk\code_repository\sponge_city\project\src\utils\ui\sponge_city.ui", "XML", 0, 650, 0, 1, 651
"e:\博士阶段\BaiduSyncdisk\code_repository\sponge_city\project\src\utils\ui_class\Block.py", "Python", 31, 0, 11, 15, 57
"e:\博士阶段\BaiduSyncdisk\code_repository\sponge_city\project\src\utils\ui_class\GreenroofInput.py", "Python", 11, 0, 4, 5, 20
"e:\博士阶段\BaiduSyncdisk\code_repository\sponge_city\project\src\utils\ui_class\RainGenerate.py", "Python", 55, 0, 11, 12, 78
"e:\博士阶段\BaiduSyncdisk\code_repository\sponge_city\project\src\utils\ui_class\SimdateOptions.py", "Python", 23, 0, 5, 6, 34
"e:\博士阶段\BaiduSyncdisk\code_repository\sponge_city\project\src\utils\ui_class\SpongeBlock.py", "Python", 182, 0, 39, 45, 266
"Total", "-", 3655, 2902, 605, 490, 7652