"filename", "language", "Python", "XML", "comment", "blank", "total"
"e:\博士阶段\BaiduSyncdisk\code_repository\sponge_city\project\src\utils\algo\bioretention_ponds.py", "Python", 58, 0, 33, 18, 109
"e:\博士阶段\BaiduSyncdisk\code_repository\sponge_city\project\src\utils\algo\concave_herbaceous_field.py", "Python", 58, 0, 33, 16, 107
"e:\博士阶段\BaiduSyncdisk\code_repository\sponge_city\project\src\utils\algo\figure_function.py", "Python", 225, 0, 43, 70, 338
"e:\博士阶段\BaiduSyncdisk\code_repository\sponge_city\project\src\utils\algo\general_functions.py", "Python", 178, 0, 20, 37, 235
"e:\博士阶段\BaiduSyncdisk\code_repository\sponge_city\project\src\utils\algo\green_roof.py", "Python", 59, 0, 33, 17, 109
"e:\博士阶段\BaiduSyncdisk\code_repository\sponge_city\project\src\utils\algo\green_roof_single.py", "Python", 366, 0, 154, 67, 587
"e:\博士阶段\BaiduSyncdisk\code_repository\sponge_city\project\src\utils\algo\non_point_pollution.py", "Python", 446, 0, 114, 73, 633
"e:\博士阶段\BaiduSyncdisk\code_repository\sponge_city\project\src\utils\algo\permeable_pavement.py", "Python", 58, 0, 33, 16, 107
"e:\博士阶段\BaiduSyncdisk\code_repository\sponge_city\project\src\utils\algo\permeable_pavement_single.py", "Python", 457, 0, 143, 57, 657
"e:\博士阶段\BaiduSyncdisk\code_repository\sponge_city\project\src\utils\algo\rain_generate.py", "Python", 17, 0, 4, 9, 30
"e:\博士阶段\BaiduSyncdisk\code_repository\sponge_city\project\src\utils\algo\sponge_block.py", "Python", 216, 0, 31, 36, 283
"e:\博士阶段\BaiduSyncdisk\code_repository\sponge_city\project\src\utils\main.py", "Python", 83, 0, 27, 14, 124
"e:\博士阶段\BaiduSyncdisk\code_repository\sponge_city\project\src\utils\ui\block.py", "Python", 502, 0, 7, 8, 517
"e:\博士阶段\BaiduSyncdisk\code_repository\sponge_city\project\src\utils\ui\block.ui", "XML", 0, 866, 0, 1, 867
"e:\博士阶段\BaiduSyncdisk\code_repository\sponge_city\project\src\utils\ui\export.py", "Python", 56, 0, 7, 8, 71
"e:\博士阶段\BaiduSyncdisk\code_repository\sponge_city\project\src\utils\ui\export.ui", "XML", 0, 155, 0, 1, 156
"e:\博士阶段\BaiduSyncdisk\code_repository\sponge_city\project\src\utils\ui\green_roof.py", "Python", 436, 0, 7, 8, 451
"e:\博士阶段\BaiduSyncdisk\code_repository\sponge_city\project\src\utils\ui\green_roof.ui", "XML", 0, 656, 0, 1, 657
"e:\博士阶段\BaiduSyncdisk\code_repository\sponge_city\project\src\utils\ui\permeable_pavement.py", "Python", 495, 0, 7, 8, 510
"e:\博士阶段\BaiduSyncdisk\code_repository\sponge_city\project\src\utils\ui\permeable_pavement.ui", "XML", 0, 691, 0, 1, 692
"e:\博士阶段\BaiduSyncdisk\code_repository\sponge_city\project\src\utils\ui\rain_generate.py", "Python", 108, 0, 7, 8, 123
"e:\博士阶段\BaiduSyncdisk\code_repository\sponge_city\project\src\utils\ui\rain_generate.ui", "XML", 0, 227, 0, 1, 228
"e:\博士阶段\BaiduSyncdisk\code_repository\sponge_city\project\src\utils\ui\sim_dates.py", "Python", 99, 0, 7, 8, 114
"e:\博士阶段\BaiduSyncdisk\code_repository\sponge_city\project\src\utils\ui\sim_dates.ui", "XML", 0, 266, 0, 1, 267
"e:\博士阶段\BaiduSyncdisk\code_repository\sponge_city\project\src\utils\ui\sponge_block.py", "Python", 167, 0, 7, 8, 182
"e:\博士阶段\BaiduSyncdisk\code_repository\sponge_city\project\src\utils\ui\sponge_block.ui", "XML", 0, 274, 0, 1, 275
"e:\博士阶段\BaiduSyncdisk\code_repository\sponge_city\project\src\utils\ui\sponge_city copy.py", "Python", 478, 0, 10, 9, 497
"e:\博士阶段\BaiduSyncdisk\code_repository\sponge_city\project\src\utils\ui\sponge_city.py", "Python", 386, 0, 10, 8, 404
"e:\博士阶段\BaiduSyncdisk\code_repository\sponge_city\project\src\utils\ui\sponge_city.ui", "XML", 0, 670, 0, 1, 671
"e:\博士阶段\BaiduSyncdisk\code_repository\sponge_city\project\src\utils\ui\ui_export.py", "Python", 69, 0, 10, 33, 112
"e:\博士阶段\BaiduSyncdisk\code_repository\sponge_city\project\src\utils\ui\ui_permeable_pavement.py", "Python", 339, 0, 10, 108, 457
"e:\博士阶段\BaiduSyncdisk\code_repository\sponge_city\project\src\utils\ui_class\Block.py", "Python", 31, 0, 11, 15, 57
"e:\博士阶段\BaiduSyncdisk\code_repository\sponge_city\project\src\utils\ui_class\Export.py", "Python", 28, 0, 9, 10, 47
"e:\博士阶段\BaiduSyncdisk\code_repository\sponge_city\project\src\utils\ui_class\GreenroofInput.py", "Python", 11, 0, 4, 5, 20
"e:\博士阶段\BaiduSyncdisk\code_repository\sponge_city\project\src\utils\ui_class\PermeablePavementInput.py", "Python", 11, 0, 4, 5, 20
"e:\博士阶段\BaiduSyncdisk\code_repository\sponge_city\project\src\utils\ui_class\RainGenerate.py", "Python", 55, 0, 11, 12, 78
"e:\博士阶段\BaiduSyncdisk\code_repository\sponge_city\project\src\utils\ui_class\SimdateOptions.py", "Python", 25, 0, 6, 6, 37
"e:\博士阶段\BaiduSyncdisk\code_repository\sponge_city\project\src\utils\ui_class\SpongeBlock.py", "Python", 184, 0, 41, 43, 268
"Total", "-", 5701, 3805, 843, 748, 11097